{
  "objects": {
    "floor" : {
      "vertices" : [
         0.0,  0.0,  0.0,
        10.0,  0.0,  0.0,
        10.0, 10.0,  0.0,
         0.0, 10.0,  0.0,
        10.0,  0.0,  0.0,
        20.0,  0.0,  0.0,
        20.0,  5.0,  0.0,
        10.0,  5.0,  0.0
      ],
  
      "textureCoords" : [
         0.0,  0.0,
        10.0,  0.0,
        10.0, 10.0,
         0.0, 10.0,
         0.0,  0.0,
        10.0,  0.0,
        10.0,  5.0,
         0.0,  5.0
      ],
  
      "indices" : [
        0, 1, 2,
        0, 2, 3,
        4, 5, 6,
        4, 6, 7
      ]
    },
    "walls" : {
      "vertices" : [
         0.0,  0.0,  0.0,
         0.0, 10.0,  0.0,
         0.0, 10.0,  1.0,
         0.0,  0.0,  1.0,
        20.0,  0.0,  0.0,
        20.0,  0.0,  1.0,
        20.0,  5.0,  0.0,
        20.0,  5.0,  1.0,
        10.0,  5.0,  0.0,
        10.0,  5.0,  1.0,
        10.0, 10.0,  0.0,
        10.0, 10.0,  1.0
      ],
  
      "textureCoords" : [
         0.0, 0.0,
        10.0, 0.0,
        10.0, 1.0,
         0.0, 1.0,
        20.0, 0.0,
        20.0, 1.0,
        15.0, 0.0,
        15.0, 1.0,
         5.0, 0.0,
         5.0, 1.0,
         0.0, 0.0,
         0.0, 1.0 
      ],
  
      "indices" : [
        0, 1, 2,
        0, 2, 3,
        0, 4, 5,
        0, 5, 3,
        4, 6, 7,
        4, 7, 5,
        6, 8, 9, 
        6, 9, 7,
        8, 10, 11,
        8, 11, 9,
        10, 1, 2,
        10, 2, 11
      ]
    }
  },
  "worlds" : {
    "default" : {
      "heightMap" : [
        [8,8,8,8,8,8,8,8,8,8,8,4,4,6,4,4,6,4,6,4,4,4,6,4],
        [8,0,0,0,0,0,0,0,0,0,8,4,0,0,0,0,0,0,0,0,0,0,0,4],
        [8,0,3,3,0,0,0,0,0,8,8,4,0,0,0,0,0,0,0,0,0,0,0,6],
        [8,0,0,3,0,0,0,0,0,0,0,0,0,0,0,0,0,0,0,0,0,0,0,6],
        [8,0,3,3,0,0,0,0,0,8,8,4,0,0,0,0,0,0,0,0,0,0,0,4],
        [8,0,0,0,0,0,0,0,0,0,8,4,0,0,0,0,0,6,6,6,0,6,4,6],
        [8,8,8,8,0,8,8,8,8,8,8,4,4,4,4,4,4,6,0,0,0,0,0,6],
        [7,7,7,7,0,7,7,7,7,0,8,0,8,0,8,0,8,4,0,4,0,6,0,6],
        [7,7,0,0,0,0,0,0,7,8,0,8,0,8,0,8,8,6,0,0,0,0,0,6],
        [7,0,0,0,0,0,0,0,0,0,0,0,0,0,0,0,8,6,0,0,0,0,0,4],
        [7,0,0,0,0,0,0,0,0,0,0,0,0,0,0,0,8,6,0,6,0,6,0,6],
        [7,7,0,0,0,0,0,0,7,8,0,8,0,8,0,8,8,6,4,6,0,6,6,6],
        [7,7,7,7,0,7,7,7,7,8,8,4,0,6,8,4,8,3,3,3,0,3,3,3],
        [2,2,2,2,0,2,2,2,2,4,6,4,0,0,6,0,6,3,0,0,0,0,0,3],
        [2,2,0,0,0,0,0,2,2,4,0,0,0,0,0,0,4,3,0,0,0,0,0,3],
        [2,0,0,0,0,0,0,0,2,4,0,0,0,0,0,0,4,3,0,0,0,0,0,3],
        [1,0,0,0,0,0,0,0,1,4,4,4,4,4,6,0,6,3,3,0,0,0,3,3],
        [2,0,0,0,0,0,0,0,2,2,2,1,2,2,2,6,6,0,0,5,0,5,0,5],
        [2,2,0,0,0,0,0,2,2,2,0,0,0,2,2,0,5,0,5,0,0,0,5,5],
        [2,0,0,0,0,0,0,0,2,0,0,0,0,0,2,5,0,5,0,5,0,5,0,5],
        [1,0,0,0,0,0,0,0,0,0,0,0,0,0,0,0,0,0,0,0,0,0,0,5],
        [2,0,0,0,0,0,0,0,2,0,0,0,0,0,2,5,0,5,0,5,0,5,0,5],
        [2,2,0,0,0,0,0,2,2,2,0,0,0,2,2,0,5,0,5,0,0,0,5,5],
        [2,2,2,2,1,2,2,2,2,2,2,1,2,2,2,5,5,5,5,5,5,5,5,5]
      ],
      "textureMap" : [
        [3,3,3,3,3,3,3,3,3,3,3,3,3,3,3,3,3,3,3,3,3,3,3,3],
        [3,0,0,0,0,0,0,0,0,0,1,2,0,0,0,0,0,0,0,0,0,0,0,3],
        [3,0,1,1,0,0,0,0,0,1,1,2,0,0,0,0,0,0,0,0,0,0,0,3],
        [3,0,0,1,0,0,0,0,0,0,0,0,0,0,0,0,0,0,0,0,0,0,0,3],
        [3,0,1,1,0,0,0,0,0,1,1,2,0,0,0,0,0,0,0,0,0,0,0,3],
        [3,0,0,0,0,0,0,0,0,0,1,2,0,0,0,0,0,2,2,2,0,2,2,3],
        [3,1,1,1,0,1,1,1,1,1,1,2,2,2,2,2,2,2,0,0,0,0,0,3],
        [3,1,1,1,0,1,1,1,1,0,1,0,2,0,2,0,2,2,0,2,0,2,0,3],
        [3,1,0,0,0,0,0,0,1,1,0,1,0,2,0,2,2,2,0,0,0,0,0,3],
        [3,0,0,0,0,0,0,0,0,0,0,0,0,0,0,0,2,2,0,0,0,0,0,3],
        [3,0,0,0,0,0,0,0,0,0,0,0,0,0,0,0,2,2,0,2,0,2,0,3],
        [3,1,0,0,0,0,0,0,1,1,0,1,0,2,0,2,2,2,2,2,0,2,2,3],
        [3,1,1,1,0,1,1,1,1,1,1,1,0,2,2,2,2,3,3,3,0,3,3,3],
        [3,2,2,2,0,2,2,2,2,1,1,1,0,0,2,0,2,3,0,0,0,0,0,3],
        [3,2,0,0,0,0,0,2,2,1,0,0,0,0,0,0,2,3,0,0,0,0,0,3],
        [3,0,0,0,0,0,0,0,2,1,0,0,0,0,0,0,2,3,0,0,0,0,0,3],
        [3,0,0,0,0,0,0,0,2,1,1,1,1,1,1,0,2,3,3,0,0,0,3,3],
        [3,0,0,0,0,0,0,0,2,2,2,2,2,2,2,2,2,0,0,2,0,2,0,3],
        [3,2,0,0,0,0,0,2,2,2,0,0,0,2,2,0,2,0,2,0,0,0,2,3],
        [3,0,0,0,0,0,0,0,2,0,0,0,0,0,2,2,0,2,0,2,0,2,0,3],
        [3,0,0,0,0,0,0,0,0,0,0,0,0,0,0,0,0,0,0,0,0,0,0,3],
        [3,0,0,0,0,0,0,0,2,0,0,0,0,0,2,2,0,2,0,2,0,2,0,3],
        [3,2,0,0,0,0,0,2,2,2,0,0,0,2,2,0,2,0,2,0,0,0,2,3],
        [3,3,3,3,3,3,3,3,3,3,3,3,3,3,3,3,3,3,3,3,3,3,3,3]
      ]
    }    
  }
}